//MAP CONVERTED BY dmm2tgm.py THIS HEADER COMMENT PREVENTS RECONVERSION, DO NOT REMOVE
"k" = (
/obj/abstract/exterior_marker/inside,
/turf/floor/rock/basalt,
/area/vesta/caves/point_of_interest/bunker)
"r" = (
/turf/floor/rock/basalt,
/area/vesta/caves/point_of_interest/bunker)
"w" = (
/obj/item/bladed/knife,
/obj/abstract/exterior_marker/inside,
/obj/abstract/exterior_marker/inside,
/turf/floor/rock/basalt,
/area/vesta/caves/point_of_interest/bunker)
"z" = (
/obj/abstract/exterior_marker/inside,
/turf/floor/grass,
/area/vesta/caves/point_of_interest/bunker)
"G" = (
/obj/item/bone/skull/deer,
/obj/item/food/butchery/stomach,
/obj/item/food/butchery/offal,
/turf/floor/rock/basalt,
/area/vesta/caves/point_of_interest/bunker)
"K" = (
/turf/template_noop,
/area/template_noop)
"M" = (
/mob/living/simple_animal/hostile/bear,
/obj/abstract/exterior_marker/inside,
/turf/floor/rock/basalt,
/area/vesta/caves/point_of_interest/bunker)
"U" = (
/obj/abstract/exterior_marker/inside,
/obj/abstract/exterior_marker/inside,
/turf/floor/rock/basalt,
/area/vesta/caves/point_of_interest/bunker)

(1,1,1) = {"
K
K
K
K
K
K
K
K
K
K
K
K
K
K
"}
(2,1,1) = {"
K
K
K
K
K
K
K
k
k
k
K
K
K
K
"}
(3,1,1) = {"
K
K
K
r
r
r
k
k
k
k
k
K
K
K
"}
(4,1,1) = {"
K
K
k
U
U
k
k
k
U
k
r
r
K
K
"}
(5,1,1) = {"
K
K
k
U
U
k
k
k
G
r
r
r
K
K
"}
(6,1,1) = {"
K
k
k
U
U
k
r
k
r
z
z
z
r
K
"}
(7,1,1) = {"
K
k
k
U
U
r
r
k
r
z
z
z
r
K
"}
(8,1,1) = {"
K
k
k
U
w
k
M
k
r
z
z
z
r
K
"}
(9,1,1) = {"
K
K
k
U
U
k
k
k
r
z
z
z
r
K
"}
(10,1,1) = {"
K
K
r
k
k
k
k
r
r
r
r
r
K
K
"}
(11,1,1) = {"
K
K
r
k
k
k
k
k
r
r
r
r
K
K
"}
(12,1,1) = {"
K
K
K
k
k
k
k
k
k
k
K
K
K
K
"}
(13,1,1) = {"
K
K
K
K
K
k
k
k
K
K
K
K
K
K
"}
(14,1,1) = {"
K
K
K
K
K
K
K
K
K
K
K
K
K
K
"}
(15,1,1) = {"
K
K
K
K
K
K
K
K
K
K
K
K
K
K
"}
